1	0	0	1280	1280	
9	0	640	640	640	
73	0	960	320	320	
585	0	1120	160	160	
586	160	1120	160	160	
587	0	960	160	160	
588	160	960	160	160	
74	320	960	320	320	
593	320	1120	160	160	
594	480	1120	160	160	
595	320	960	160	160	
596	480	960	160	160	
75	0	640	320	320	
601	0	800	160	160	
602	160	800	160	160	
603	0	640	160	160	
604	160	640	160	160	
76	320	640	320	320	
609	320	800	160	160	
610	480	800	160	160	
611	320	640	160	160	
612	480	640	160	160	
10	640	640	640	640	
81	640	960	320	320	
649	640	1120	160	160	
650	800	1120	160	160	
651	640	960	160	160	
652	800	960	160	160	
82	960	960	320	320	
657	960	1120	160	160	
658	1120	1120	160	160	
659	960	960	160	160	
660	1120	960	160	160	
83	640	640	320	320	
665	640	800	160	160	
666	800	800	160	160	
667	640	640	160	160	
668	800	640	160	160	
84	960	640	320	320	
673	960	800	160	160	
674	1120	800	160	160	
675	960	640	160	160	
676	1120	640	160	160	
11	0	0	640	640	
89	0	320	320	320	
713	0	480	160	160	
714	160	480	160	160	
715	0	320	160	160	0	1	2	3	4	32	33	34	35	36	64	65	66	67	68	
716	160	320	160	160	4	5	6	7	8	9	36	37	38	39	40	41	68	69	70	71	72	73	
90	320	320	320	320	
721	320	480	160	160	
722	480	480	160	160	
723	320	320	160	160	9	10	11	12	13	14	41	42	43	44	45	46	73	74	75	76	77	78	
724	480	320	160	160	14	15	16	17	18	19	46	47	48	49	50	51	78	79	80	81	82	83	
91	0	0	320	320	
729	0	160	160	160	64	65	66	67	68	96	97	98	99	100	128	129	130	131	132	160	161	162	163	164	192	193	194	195	196	224	225	226	227	228	
730	160	160	160	160	68	69	70	71	72	73	100	101	102	103	104	105	132	133	134	135	136	137	164	165	166	167	168	169	196	197	198	199	200	201	228	229	230	231	232	233	
731	0	0	160	160	224	225	226	227	228	256	257	258	259	260	288	289	290	291	292	320	321	322	323	324	352	353	354	355	356	
732	160	0	160	160	228	229	230	231	232	233	260	261	262	263	264	265	292	293	294	295	296	297	324	325	326	327	328	329	356	357	358	359	360	361	
92	320	0	320	320	
737	320	160	160	160	73	74	75	76	77	78	105	106	107	108	109	110	137	138	139	140	141	142	169	170	171	172	173	174	201	202	203	204	205	206	233	234	235	236	237	238	
738	480	160	160	160	78	79	80	81	82	83	110	111	112	113	114	115	142	143	144	145	146	147	174	175	176	177	178	179	206	207	208	209	210	211	238	239	240	241	242	243	
739	320	0	160	160	233	234	235	236	237	238	265	266	267	268	269	270	297	298	299	300	301	302	329	330	331	332	333	334	361	362	363	364	365	366	
740	480	0	160	160	238	239	240	241	242	243	270	271	272	273	274	275	302	303	304	305	306	307	334	335	336	337	338	339	366	367	368	369	370	371	
12	640	0	640	640	
97	640	320	320	320	
777	640	480	160	160	
778	800	480	160	160	
779	640	320	160	160	19	20	21	22	23	24	51	52	53	54	55	56	83	84	85	86	87	88	
780	800	320	160	160	24	25	26	27	28	29	56	57	58	59	60	61	88	89	90	91	92	93	
98	960	320	320	320	
785	960	480	160	160	
786	1120	480	160	160	
787	960	320	160	160	29	30	31	61	62	63	93	94	95	
788	1120	320	160	160	
99	640	0	320	320	
793	640	160	160	160	83	84	85	86	87	88	115	116	117	118	119	120	147	148	149	150	151	152	179	180	181	182	183	184	211	212	213	214	215	216	243	244	245	246	247	248	
794	800	160	160	160	88	89	90	91	92	93	120	121	122	123	124	125	152	153	154	155	156	157	184	185	186	187	188	189	216	217	218	219	220	221	248	249	250	251	252	253	
795	640	0	160	160	243	244	245	246	247	248	275	276	277	278	279	280	307	308	309	310	311	312	339	340	341	342	343	344	371	372	373	374	375	376	
796	800	0	160	160	248	249	250	251	252	253	280	281	282	283	284	285	312	313	314	315	316	317	344	345	346	347	348	349	376	377	378	379	380	381	
100	960	0	320	320	
801	960	160	160	160	93	94	95	125	126	127	157	158	159	189	190	191	221	222	223	253	254	255	
802	1120	160	160	160	
803	960	0	160	160	253	254	255	285	286	287	317	318	319	349	350	351	381	382	383	
804	1120	0	160	160