1	0	0	768	768	
9	0	384	384	384	
73	0	576	192	192	
74	192	576	192	192	
75	0	384	192	192	0	1	2	3	4	5	
76	192	384	192	192	5	6	7	8	9	10	11	
10	384	384	384	384	
81	384	576	192	192	
82	576	576	192	192	
83	384	384	192	192	11	12	13	14	15	
84	576	384	192	192	
11	0	0	384	384	
89	0	192	192	192	0	1	2	3	4	5	16	17	18	19	20	21	32	33	34	35	36	37	48	49	50	51	52	53	64	65	66	67	68	69	80	81	82	83	84	85	96	97	98	99	100	101	
90	192	192	192	192	5	6	7	8	9	10	11	21	22	23	24	25	26	27	37	38	39	40	41	42	43	53	54	55	56	57	58	59	69	70	71	72	73	74	75	85	86	87	88	89	90	91	101	102	103	104	105	106	107	
91	0	0	192	192	96	97	98	99	100	101	112	113	114	115	116	117	128	129	130	131	132	133	144	145	146	147	148	149	160	161	162	163	164	165	176	177	178	179	180	181	
92	192	0	192	192	101	102	103	104	105	106	107	117	118	119	120	121	122	123	133	134	135	136	137	138	139	149	150	151	152	153	154	155	165	166	167	168	169	170	171	181	182	183	184	185	186	187	
12	384	0	384	384	
97	384	192	192	192	11	12	13	14	15	27	28	29	30	31	43	44	45	46	47	59	60	61	62	63	75	76	77	78	79	91	92	93	94	95	107	108	109	110	111	
98	576	192	192	192	
99	384	0	192	192	107	108	109	110	111	123	124	125	126	127	139	140	141	142	143	155	156	157	158	159	171	172	173	174	175	187	188	189	190	191	
100	576	0	192	192