1	0	0	1680	1680	
9	0	840	840	840	
73	0	1260	420	420	
585	0	1470	210	210	
586	210	1470	210	210	
587	0	1260	210	210	
588	210	1260	210	210	
74	420	1260	420	420	
593	420	1470	210	210	
594	630	1470	210	210	
595	420	1260	210	210	
596	630	1260	210	210	
75	0	840	420	420	
601	0	1050	210	210	
602	210	1050	210	210	
603	0	840	210	210	
604	210	840	210	210	
76	420	840	420	420	
609	420	1050	210	210	
610	630	1050	210	210	
611	420	840	210	210	
612	630	840	210	210	
10	840	840	840	840	
81	840	1260	420	420	
649	840	1470	210	210	
650	1050	1470	210	210	
651	840	1260	210	210	
652	1050	1260	210	210	
82	1260	1260	420	420	
657	1260	1470	210	210	
658	1470	1470	210	210	
659	1260	1260	210	210	
660	1470	1260	210	210	
83	840	840	420	420	
665	840	1050	210	210	
666	1050	1050	210	210	
667	840	840	210	210	
668	1050	840	210	210	
84	1260	840	420	420	
673	1260	1050	210	210	
674	1470	1050	210	210	
675	1260	840	210	210	
676	1470	840	210	210	
11	0	0	840	840	
89	0	420	420	420	
713	0	630	210	210	
714	210	630	210	210	
715	0	420	210	210	
716	210	420	210	210	
90	420	420	420	420	
721	420	630	210	210	
722	630	630	210	210	
723	420	420	210	210	
724	630	420	210	210	
91	0	0	420	420	
729	0	210	210	210	0	1	2	3	4	5	6	48	49	50	51	52	53	54	96	97	98	99	100	101	102	144	145	146	147	148	149	150	192	193	194	195	196	197	198	240	241	242	243	244	245	246	
730	210	210	210	210	6	7	8	9	10	11	12	54	55	56	57	58	59	60	102	103	104	105	106	107	108	150	151	152	153	154	155	156	198	199	200	201	202	203	204	246	247	248	249	250	251	252	
731	0	0	210	210	240	241	242	243	244	245	246	288	289	290	291	292	293	294	336	337	338	339	340	341	342	384	385	386	387	388	389	390	432	433	434	435	436	437	438	480	481	482	483	484	485	486	528	529	530	531	532	533	534	
732	210	0	210	210	246	247	248	249	250	251	252	294	295	296	297	298	299	300	342	343	344	345	346	347	348	390	391	392	393	394	395	396	438	439	440	441	442	443	444	486	487	488	489	490	491	492	534	535	536	537	538	539	540	
92	420	0	420	420	
737	420	210	210	210	12	13	14	15	16	17	18	19	60	61	62	63	64	65	66	67	108	109	110	111	112	113	114	115	156	157	158	159	160	161	162	163	204	205	206	207	208	209	210	211	252	253	254	255	256	257	258	259	
738	630	210	210	210	19	20	21	22	23	24	25	67	68	69	70	71	72	73	115	116	117	118	119	120	121	163	164	165	166	167	168	169	211	212	213	214	215	216	217	259	260	261	262	263	264	265	
739	420	0	210	210	252	253	254	255	256	257	258	259	300	301	302	303	304	305	306	307	348	349	350	351	352	353	354	355	396	397	398	399	400	401	402	403	444	445	446	447	448	449	450	451	492	493	494	495	496	497	498	499	540	541	542	543	544	545	546	547	
740	630	0	210	210	259	260	261	262	263	264	265	307	308	309	310	311	312	313	355	356	357	358	359	360	361	403	404	405	406	407	408	409	451	452	453	454	455	456	457	499	500	501	502	503	504	505	547	548	549	550	551	552	553	
12	840	0	840	840	
97	840	420	420	420	
777	840	630	210	210	
778	1050	630	210	210	
779	840	420	210	210	
780	1050	420	210	210	
98	1260	420	420	420	
785	1260	630	210	210	
786	1470	630	210	210	
787	1260	420	210	210	
788	1470	420	210	210	
99	840	0	420	420	
793	840	210	210	210	25	26	27	28	29	30	31	32	73	74	75	76	77	78	79	80	121	122	123	124	125	126	127	128	169	170	171	172	173	174	175	176	217	218	219	220	221	222	223	224	265	266	267	268	269	270	271	272	
794	1050	210	210	210	32	33	34	35	36	37	38	80	81	82	83	84	85	86	128	129	130	131	132	133	134	176	177	178	179	180	181	182	224	225	226	227	228	229	230	272	273	274	275	276	277	278	
795	840	0	210	210	265	266	267	268	269	270	271	272	313	314	315	316	317	318	319	320	361	362	363	364	365	366	367	368	409	410	411	412	413	414	415	416	457	458	459	460	461	462	463	464	505	506	507	508	509	510	511	512	553	554	555	556	557	558	559	560	
796	1050	0	210	210	272	273	274	275	276	277	278	320	321	322	323	324	325	326	368	369	370	371	372	373	374	416	417	418	419	420	421	422	464	465	466	467	468	469	470	512	513	514	515	516	517	518	560	561	562	563	564	565	566	
100	1260	0	420	420	
801	1260	210	210	210	38	39	40	41	42	43	44	45	86	87	88	89	90	91	92	93	134	135	136	137	138	139	140	141	182	183	184	185	186	187	188	189	230	231	232	233	234	235	236	237	278	279	280	281	282	283	284	285	
802	1470	210	210	210	45	46	47	93	94	95	141	142	143	189	190	191	237	238	239	285	286	287	
803	1260	0	210	210	278	279	280	281	282	283	284	285	326	327	328	329	330	331	332	333	374	375	376	377	378	379	380	381	422	423	424	425	426	427	428	429	470	471	472	473	474	475	476	477	518	519	520	521	522	523	524	525	566	567	568	569	570	571	572	573	
804	1470	0	210	210	285	286	287	333	334	335	381	382	383	429	430	431	477	478	479	525	526	527	573	574	575
