1	0	0	1792	1792	
9	0	896	896	896	
73	0	1344	448	448	
585	0	1568	224	224	
586	224	1568	224	224	
587	0	1344	224	224	
588	224	1344	224	224	
74	448	1344	448	448	
593	448	1568	224	224	
594	672	1568	224	224	
595	448	1344	224	224	
596	672	1344	224	224	
75	0	896	448	448	
601	0	1120	224	224	
602	224	1120	224	224	
603	0	896	224	224	
604	224	896	224	224	
76	448	896	448	448	
609	448	1120	224	224	
610	672	1120	224	224	
611	448	896	224	224	
612	672	896	224	224	
10	896	896	896	896	
81	896	1344	448	448	
649	896	1568	224	224	
650	1120	1568	224	224	
651	896	1344	224	224	
652	1120	1344	224	224	
82	1344	1344	448	448	
657	1344	1568	224	224	
658	1568	1568	224	224	
659	1344	1344	224	224	
660	1568	1344	224	224	
83	896	896	448	448	
665	896	1120	224	224	
666	1120	1120	224	224	
667	896	896	224	224	
668	1120	896	224	224	
84	1344	896	448	448	
673	1344	1120	224	224	
674	1568	1120	224	224	
675	1344	896	224	224	
676	1568	896	224	224	
11	0	0	896	896	
89	0	448	448	448	
713	0	672	224	224	
714	224	672	224	224	
715	0	448	224	224	
716	224	448	224	224	
90	448	448	448	448	
721	448	672	224	224	
722	672	672	224	224	
723	448	448	224	224	
724	672	448	224	224	
91	0	0	448	448	
729	0	224	224	224	0	1	2	3	4	5	6	48	49	50	51	52	53	54	96	97	98	99	100	101	102	144	145	146	147	148	149	150	192	193	194	195	196	197	198	240	241	242	243	244	245	246	
730	224	224	224	224	6	7	8	9	10	11	12	13	54	55	56	57	58	59	60	61	102	103	104	105	106	107	108	109	150	151	152	153	154	155	156	157	198	199	200	201	202	203	204	205	246	247	248	249	250	251	252	253	
731	0	0	224	224	240	241	242	243	244	245	246	288	289	290	291	292	293	294	336	337	338	339	340	341	342	384	385	386	387	388	389	390	432	433	434	435	436	437	438	480	481	482	483	484	485	486	528	529	530	531	532	533	534	
732	224	0	224	224	246	247	248	249	250	251	252	253	294	295	296	297	298	299	300	301	342	343	344	345	346	347	348	349	390	391	392	393	394	395	396	397	438	439	440	441	442	443	444	445	486	487	488	489	490	491	492	493	534	535	536	537	538	539	540	541	
92	448	0	448	448	
737	448	224	224	224	13	14	15	16	17	18	19	20	61	62	63	64	65	66	67	68	109	110	111	112	113	114	115	116	157	158	159	160	161	162	163	164	205	206	207	208	209	210	211	212	253	254	255	256	257	258	259	260	
738	672	224	224	224	20	21	22	23	24	25	26	27	68	69	70	71	72	73	74	75	116	117	118	119	120	121	122	123	164	165	166	167	168	169	170	171	212	213	214	215	216	217	218	219	260	261	262	263	264	265	266	267	
739	448	0	224	224	253	254	255	256	257	258	259	260	301	302	303	304	305	306	307	308	349	350	351	352	353	354	355	356	397	398	399	400	401	402	403	404	445	446	447	448	449	450	451	452	493	494	495	496	497	498	499	500	541	542	543	544	545	546	547	548	
740	672	0	224	224	260	261	262	263	264	265	266	267	308	309	310	311	312	313	314	315	356	357	358	359	360	361	362	363	404	405	406	407	408	409	410	411	452	453	454	455	456	457	458	459	500	501	502	503	504	505	506	507	548	549	550	551	552	553	554	555	
12	896	0	896	896	
97	896	448	448	448	
777	896	672	224	224	
778	1120	672	224	224	
779	896	448	224	224	
780	1120	448	224	224	
98	1344	448	448	448	
785	1344	672	224	224	
786	1568	672	224	224	
787	1344	448	224	224	
788	1568	448	224	224	
99	896	0	448	448	
793	896	224	224	224	27	28	29	30	31	32	33	34	75	76	77	78	79	80	81	82	123	124	125	126	127	128	129	130	171	172	173	174	175	176	177	178	219	220	221	222	223	224	225	226	267	268	269	270	271	272	273	274	
794	1120	224	224	224	34	35	36	37	38	39	40	41	82	83	84	85	86	87	88	89	130	131	132	133	134	135	136	137	178	179	180	181	182	183	184	185	226	227	228	229	230	231	232	233	274	275	276	277	278	279	280	281	
795	896	0	224	224	267	268	269	270	271	272	273	274	315	316	317	318	319	320	321	322	363	364	365	366	367	368	369	370	411	412	413	414	415	416	417	418	459	460	461	462	463	464	465	466	507	508	509	510	511	512	513	514	555	556	557	558	559	560	561	562	
796	1120	0	224	224	274	275	276	277	278	279	280	281	322	323	324	325	326	327	328	329	370	371	372	373	374	375	376	377	418	419	420	421	422	423	424	425	466	467	468	469	470	471	472	473	514	515	516	517	518	519	520	521	562	563	564	565	566	567	568	569	
100	1344	0	448	448	
801	1344	224	224	224	41	42	43	44	45	46	47	89	90	91	92	93	94	95	137	138	139	140	141	142	143	185	186	187	188	189	190	191	233	234	235	236	237	238	239	281	282	283	284	285	286	287	
802	1568	224	224	224	
803	1344	0	224	224	281	282	283	284	285	286	287	329	330	331	332	333	334	335	377	378	379	380	381	382	383	425	426	427	428	429	430	431	473	474	475	476	477	478	479	521	522	523	524	525	526	527	569	570	571	572	573	574	575	
804	1568	0	224	224
