10	47
32	32
0	0	1	2	3	2	3	4	5	6	5	6	7	0	0	0	0	0	8	9	10	11	12	13	12	13	14	15	16	0	0	0	0	0	0	0	0	0	0	0	17	18	19	20	21	22	23	
24	25	26	27	28	27	28	29	30	31	30	31	32	33	33	33	34	35	36	37	38	39	40	41	40	41	42	43	44	33	33	33	33	33	33	33	33	33	33	33	45	46	47	48	49	50	51	
52	53	54	55	56	55	56	57	58	59	58	59	60	61	62	61	63	64	65	64	65	66	67	68	67	68	69	70	71	72	73	74	75	74	75	76	77	78	77	78	79	80	81	82	83	84	85	
86	87	88	89	90	91	92	93	94	95	94	95	96	97	98	97	99	100	101	102	103	104	105	106	105	106	107	108	109	110	111	112	113	112	113	114	115	116	117	116	118	119	120	121	122	123	124	
125	126	127	128	129	130	131	132	133	134	133	134	135	136	135	136	137	138	139	140	141	142	143	144	143	144	145	146	147	146	148	149	150	149	150	151	152	153	154	153	155	156	157	158	159	160	161	
162	163	164	165	166	89	167	168	169	170	169	170	171	172	171	172	173	102	174	175	176	177	178	179	178	179	180	181	182	181	183	184	185	184	185	186	187	188	165	188	165	189	190	191	192	123	193	
194	195	196	197	198	128	198	199	200	201	200	201	202	203	202	203	204	140	205	206	207	208	209	210	209	210	211	212	211	212	213	214	215	214	215	216	217	218	165	165	165	156	219	220	159	160	221	
222	223	224	225	164	226	227	228	229	230	231	165	232	233	234	235	236	237	238	239	240	241	242	243	244	243	165	245	246	247	248	249	165	249	165	249	250	251	252	165	165	253	254	255	256	257	258	
259	260	261	262	263	264	265	266	267	268	269	270	271	272	273	274	275	276	277	278	279	280	281	282	283	282	284	285	286	287	288	289	289	289	290	291	292	293	294	295	296	297	298	299	300	301	302	
303	304	305	306	307	308	309	310	311	312	313	314	315	316	317	318	319	320	321	322	323	324	325	326	327	326	328	329	330	331	332	333	333	333	334	335	336	337	338	339	340	341	342	343	344	345	346	
